11111111111111
10000000010101
10100000010101
10101111110001
10100000011101
10111111000101
1x001110000101
11111000001101
10000011111001
10010010000001
10010010111111
10011110100001
10000000000001
11111111111111
